00000000000000000
00011111000111110
00111100001111000
01110000011100000
01100000011000000
01110000011100000
00111100001111000
00011111000111110
33333444444433333
00000000000000000
02333322222333320
22333000000033322
23300000000000332
03300001110000330
03300001510000330