00000000000000000
00220033333002200
00220000000002200
00220033333002200
01110000000001110
00000011111000000
22220111111102222
00000000000000000
00003333333330000
22044444444444022
00000000000000000
00000011111000000
01110000000001110
01100001110000110
01000001510000010