00000000000000000
01111100000111110
01010104440100010
01111101110111110
01111101110111110
01010104440100010
01111100000111110
00000000000000000
22001112221110022
00000011111000000
33333001110003333
33333000100003333
01111000000001110
01000001110000010
01000001510000010