00020000000002000
00300001110000300
00000011111000000
00000110001100000
00001110001110000
00011110001111000
00110000400001100
01110004440001110
01110000000001110
00000000000000000
33300002220000333
33001110001110033
32201000000010223
00001001110010000
01100001510000110