00033000000033000
00033333333333000
01111100000111110
01111102220111110
01111100000111110
03333302220333330
03333300000333330
11111111111111111
11001111111110011
00000000000000000
44444000000044444
00000033333000000
11110002220001111
12210001110001221
11110001510001111