00011000000100000
33330000000100000
00330101000100022
00044434444440000
00000000000000000
00001111000002120
12100000000000000
33330000000033333
00000021112102121
01111000000000000
00000012212000000
00333300100000000
00222000000011110
00111001110000000
01110001510000000