00111000000011100
00010000000001000
00111002220011100
00000033333000000
00011111111111000
00000000000000000
33300000000000333
00000011111000000
00000001110000000
11110000100001111
00444000200044400
00000333333300000
04400000000000440
01110001110001110
00100001510000100