00000000000000000
00000100011111110
11100100000011000
10111111011111110
11100100000011000
00000100011111110
00000000000000000
00000002220000000
33333000000033333
00000444444400000
11000000000000011
00000002220000000
11110000000001111
00000001110000000
02200001510000220