00002200000000300
01100000000020000
00011001100020000
00300110000011200
00333300022000211
00000000020033300
00111000000444000
44444000000000000
00000001111000000
00111000220003330
00000000000000220
03333300200000000
00000000000111110
01111001110002220
10000001510000000